  ########
#     $  #
## $##  ##
#    #   #
##   #$  #
###   #  #
# #$  # ##
# $      #
#    $# $#
########  
